0000000000000000000000000000
0111111111111111111111111100
0122222000000000000000021100
0111100001111111111000021100
0111122222111111111000021100
0111122222111111111000021100
0111100001111111111000021100
0122222000000000000000021100
0111111111111111111111111100
0122222000000000000000021100
0111100001111111111000021100
0111122222111111111000021100
0111122222111111111000021100
0111100001111111111000021100
0122222000000000000000021100
0111111111111111111111111100
0122222000000000000000021100
0111100001111111111000021100
0111122222111111111000021100
0000000000000000000000000000