0000000000000000000000000000
0111111111111111111111111110
0122222333333333333333321110
0111133331111111111333321110
0111122222111111111333321110
0111122222111111111333321110
0111133331111111111333321110
0122222333333333333333321110
0111111111111111111111111110
0122222333333333333333321110
0111133331111111111333321110
0111122222111111111333321110
0111122222111111111333321110
0111133331111111111333321110
0122222333333333333333321110
0111111111111111111111111110
0122222333333333333333321110
0111133331111111111333321110
0111122222111111111333321110
0000000000000000000000000000

